10
10
1111111111
1022222221
1002222221
1000222221
1000020001
1000222001
1111121111
1000222121
1222222221
1111111111

