20
20
11111111111111111111
10222222222220002221
10022222212220022001
10002222212200022201
10000200012220022221
10002220011122222221
11111211112222222221
10002221212222222221
12222222222222222221
12222222222222222221
12222222211111111111
12222222222222222221
12222222222222222221
12222222222222222221
11111111112222222221
12222222212222222221
12222222211111122221
12222222222222222221
12222222222222222221
11111111111111111111
